AED - United Arab Emirates Dirham
AUD - Australian Dollar
BGN - Bulgarian Lev
BRL - Brazilian Real
CAD - Canadian Dollar
CHF - Swiss Franc
CLP - Chilean Peso
CNY - Chinese Yuan
COP - Colombian Peso
CZK - Czech Koruna
DKK - Danish Krone
EUR - Euro
GBP - British Pound Sterling
HKD - Hong Kong Dollar
HRK - Croatian Kuna
HUF - Hungarian Forint
IDR - Indonesian Rupiah
ILS - Israeli New Shekel
INR - Indian Rupee
JOD - Jordanian Dinar
JPY - Japanese Yen
MAD - Moroccan Dirham
MXN - Mexican Peso
MYR - Malaysian Ringgit
NOK - Norwegian Krone
NZD - New Zealand Dollar
PHP - Philippine Peso
PLN - Polish Złoty
RON - Romanian Leu
RUB - Russian Ruble
SAR - Saudi Riyal
SEK - Swedish Krona
SGD - Singapore Dollar
THB - Thai Baht
TWD - Taiwan Dollar
USD - United States Dollar
VND - Vietnamese đồng
ZAR - South African Rand